S..##################
..###################
........#.....#.#...#
#.#####.###.###.#.###
#.#.#.........#.#...#
#.#.###.#####.#.#.###
#...#...#.......#...#
###.#.###.###.###.#.#
#.......#.#.#.#...#.#
#.###.#####.#.#.#####
#.#.........#...#...#
#####.###.#####.#.#.#
#.#...#.....#.....#.#
#.#####.#######.#.###
#.....#.......#.#.#.#
#.#.###.###.#.#####.#
#.#.#.....#.#.#...#.#
###.#.#.#.###.#.###.#
#.#.#.#.#.#.......#.#
#.#.###.###.#.###.#.#
#.......#...#.#......
###################.F
