..###############################
......#.#...#.........#.......#.#
#.###.#.###.#.#####.#.###.###.#.#
#...#S#.....#.#.....#.......#.#.#
#.#.#######.###########.#.#####.#
#.#...#.......#...#.#...#.#.....#
###.#.#.#######.###.###.#######.#
#...#.#...#.#.#.......#.#...#...#
#####.#.###.#.#.#####.#.#.#.#.#.#
#.#.....#.#.........#...#.#.#.#.#
#.###.#.#.#.#.###.#########.#.###
#.#.#.#.....#...#...#...#...#...#
#.#.###############.###.###.#.#.#
#.......#.#.#.#.#.#...#.....#.#.#
###.###.#.#.#.#.#.#.#######.#.###
#...#.#.....#...#.#.#.#.........#
#.###.#.#.#.#.###.#.#.#.#######.#
#.#.....#.#.#.............#.....#
#.###.#.#####.###.#############.#
#.#...#.......#.#...#.....#...#.#
#####.#.#.###.#.###.#.###.#.#####
#.#...#.#.#.#...#.....#.#.#.#...#
#.#######.#.#########.#.#.#.###.#
#.#.....#...#.#.....#...#...#...#
#.###.#.#.#.#.###.###.#####F#.#.#
