S.###############################################################
........#.#.....#.............#.#.....#.....#...#.....#.#...#...#
###.###.#.#####.#.###.#.#.#.#.#.#.#.#.###.#####.###.#.#.#.#.#.###
#...#...#.#.#.#.#.#...#.#.#.#.....#.#...#...#.......#.....#.#...#
#######.#.#.#.#.#######.###.#.#############.#.#.#######.#####.###
#.........................#.#.#...........#...#.#...............#
###.#.#######.#######.#.#######.###.#######.###.###.###.###.###.#
#...#.#.....#...#.#.#.#...#.#.#...#.#...#...#...#...#...#.....#.#
###.#.###.#.#.###.#.#####.#.#.###.#.#.#####.###.#######.###.#####
#...#.#...#.#.#.#...#.#.......#...#...#.....#.....#.#...#.......#
#.#.#####.#####.#.###.#######.###.#.#####.###.#####.#.###.#####.#
#.#...#.#.#.#.#.#.........#...#.#.#.#...#.#...#.#...#.#.......#.#
#.#####.#.#.#.#.#.#####.#####.#.#.#.###.#.#.#.#.#.###.#######.###
#.....#...#.........#.....#...#.#.#...#.#.#.#.......#...#.......#
#.#.###.#####.#########.#.#.#.#.###.#.#.###.#.###.###.#######.#.#
#.#.#.#.....#.....#...#.#.#.#.....#.#.......#.#...#...#.#...#.#.#
#.###.###.#.#.###.###.###.#######.###.###########.#####.###.###.#
#.....#...#.#.#...#...#...#.....#.#...#...#.....#...#.....#...#.#
#####.###.###.###.###.###.###.###.###.###.###.#########.#.###.###
#.......#.......#.#.....#...#...........#.....#...#.....#.#...#.#
###.#.###.#####.#####.#.#.#.#.#####.#####.###.###.#.###.#####.#.#
#...#...#.#...#.....#.#...#.#.#.#.......#.#.#.....#.#...........#
#######.#.###.###.#############.#.#####.#.#.###.#############.###
#.....#.#.#...........#.........#...#...#.#.#.#...#...#...#...#.#
#.###.###.###########.###.###.#.#.#####.#.#.#.###.###.###.###.#.#
#.#...#...#.#.....#.#.#...#...#.......#.#.....#...#.#.#...#.#.#.#
###.#####.#.#####.#.#.#############.#########.#####.#.###.#.#.#.#
#.#.#.#.#...#...#.#.#.........#.#...#.#.....#.#.#...........#...#
#.#.#.#.###.#.#.#.#.#####.###.#.#.#.#.#.#.###.#.###########.#.###
#.#...#...#...#.#.#...#.#.#...#...#.#...#.#...#.#.....#...#.....#
#.#.###.#.#.#.###.###.#.#.###.#.#######.###.###.#.#######.#.#####
#.......#.#.#.......#.....#.........#.............#...#...#.#...#
#.#.#.#.#.###.###.#####.###.###.#######.#######.###.###.###.#.###
#.#.#.#.#.#.#...#.#...#...#...#.............#.#.#.#.......#.....#
#.###.###.#.#########.#.#.#####.#.#.#########.#.#.#.###.###.#.###
#.#...#.#.#.....#.......#...#...#.#.#.#.......#.....#.....#.#...#
#.###.#.#####.###.#.#######.###.#.###.#.#############.#.###.#####
#...#.#.#...#.....#.#.......#...#.........#...#.......#.#...#...#
#.#.###.#.#.#.#.###.#.#.#.#.#############.#.#.#########.#.###.#.#
#.#...#...#...#.#...#.#.#.#.#.......#...#...#.....#...#.....#.#.#
#.#.#.#.#.#.#######.###.###.###.###.#.#######.#.###.#.#######.###
#.#.#...#.#...#...#...#...#...#.#.....#...#...#.....#...#.....#.#
###.#############.#.#.###.#.#########.###.#.###########.#.#.#.#.#
#.....#.....#.....#.#...#.#.#...#.#.#.#...#.#.#.....#.....#.#.#.#
#.#.#.#.###.#####.###.###.###.###.#.#.###.#.#.#.#####.#.#.###.#.#
#.#.#.#.#...#.#...#.#.#.#.......#...................#.#.#.#.....#
#####.#.###.#.###.#.#.#.#####.###.###.#.###########.###.###.###.#
#...#.#.#...#.#.....#.#.....#.#...#...#.......#...#.#.....#.#.#.#
#.#######.#.#.#.#.#######.#.#####.#######.#####.###.#########.#.#
#.....#...#.#...#.#.#.#...#.#.#.#.#.......#.#.#.....#...#.......#
#.#.#####.#######.#.#.#####.#.#.#######.#.#.#.#.###.###.#.#####.#
#.#.#.....#...#.#.....#.......#.#.#...#.#...#.#...#...#...#...#.#
#.#######.###.#.###.###.#.#####.#.###.#.#####.#####.#####.#.###.#
#.........#...#...#.#.#.#.#...........#.#.......#.....#.#.#.....#
#.#.#####.###.#.###.#.#.###.###.#.#.#.#.#.###.#.#.#####.###.#####
#.#.#...#.#...........#.......#.#.#.#...#.#...#.#.#.#.#...#.....#
#.###.#.#.#.#######.###########.###.#.#.###.#.#.#.#.#.#.###.#.###
#...#.#.#...#...#.#...#.#.........#.#.#...#.#.#.#.#.....#.#.#...#
#####.#######.###.#.#.#.#.###.#######.#####.#####.#.#.#.#.#.#####
#...#.#.#.#.#...#...#.....#.........#.....#.......#.#.#.#...#...#
#.###.#.#.#.#.###.#########.#.#####.#####.#.#.###.#####.#####.###
#.#.....#...#...#.......#...#.#.#.#.#...#.#.#.#.#.#...#.......#.#
#.#.#.###.#.###.###.#####.#.###.#.#####.###.###.#.#.###.#####.#.#
#...#.....#...........#...#...#.............#...........#........
###############################################################.F
