..###############
.....S..#.#.....#
#.#######.#.###.#
#.#.......#...#.#
#.###.#.#####.#.#
#...#.#.......#.#
#.#.#####.###.###
#.#.#.#.#...#...#
###.#.#.#.###.#.#
#.#...#.....#.#.#
#.###.#.#.#####.#
#.#...#.#.#.#...#
#.###.#.#.#.###.#
#.......#...#...#
#.#.#.#.#.#.###.#
#.#.#.#.#.#.#....
###############.F
