#################
#...#...#....S..#
#.###.###.#######
#.#...#.....#...#
#.#.#####.#.#.###
#.......#.#.....#
#.###.#.#.###.###
#.#.#.#...#.#...#
#.#.###.###.#.#.#
#.....#.#.....#.#
#.###.#####.#.#.#
#.#.....#...#.#.#
#.###.#.###.#####
#...#.#.#.......#
#.#########.###.#
#.....#.......#..
###############.F
